11111111
1P0000E1
1000C001
11111111